......3......
.............
....1...1....
.............
..0...3...0..
.............
2..2..1..2..2
.............
..0...3...0..
.............
....1...1....
.............
......3......