......1......
.............
....4...3....
.............
..1.......1..
.....512.....
.2...151...2.
.....215.....
..1.......1..
.............
....3...4....
.............
......1......