......4......
.............
....3...3....
.............
..1...3...1..
.............
4..2..1..2..4
.............
..1...3...1..
.............
....3...3....
.............
......4......