......1......
.............
....3...3....
......4......
..1.......1..
.....512.....
.2...151...2.
.....215.....
..1.......1..
......4......
....3...3....
.............
......1......