......0......
.............
....3...3....
.............
..1...3...1..
.............
0..2..1..2..0
.............
..1...3...1..
.............
....3...3....
.............
......0......