.............
6...........6
.............
.............
.............
.....666.....
.....555.....
.....121.....
.............
.............
.............
6...........6
.............