.............
1...........1
.............
.............
.............
.....626.....
.....353.....
.....626.....
...1111111...
.............
.............
1...........1
.............