.............
1...........1
.2.........2.
..3.......3..
...4.....4...
...3.626.3...
....55555....
...3.626.3...
...4.....4...
..3.......3..
.2.........2.
1...........1
.............