.............
1...........1
.............
.............
.............
.....121.....
.....555.....
.....121.....
.............
.............
.............
1...........1
.............